15 15 15 15 15 15 15 15 15 15 15 15 15 15 15 15 15 15 15 15 15 15 15 15 15 15 15 15 15 15 15 15 15 15 15 15 15 15 15 15 15 15 15 15 15 15 15 15 15 15 15 15 15 15 15 15 15 15 15 15
15 25 22 22 22 22 22 22 22 22 22 22 22 22 22 22 22 22 22 22 26 15 15 15 15 15 15 15 15 15 15 15 29 15 25 22 22 22 22 22 22 22 22 22 22 22 22 22 22 22 22 22 22 22 22 22 22 22 26 15
15 20 14 11 14 14 11 14 11 14 14 14 11 14 14 11 11 14 14 14 19 15 29 15 15 15 15 15 15 15 15 15 15 15 20 14 14 14 11 14 11 11 11 14 14 14 11 11 11 11 11 11 14 14 14 14 11 14 19 15
15 20 11 14 14 11 14 11 14 11 11 14 14 11 14 14 14 11 14 14 21 22 22 22 22 22 22 22 22 22 22 22 22 22 23 11 14 14 11 14 14 11 11 11 14 11 11 14 11 14 11 14 14 11 11 11 11 14 19 15
15 20 11 14 14 11 11 14 14 11 14 11 14 14 11 11 14 14 11 11 11 11 11 11 11 11 11 11 14 11 11 14 11 11 11 11 11 11 11 11 11 11 11 14 11 14 11 11 14 14 11 14 11 11 11 11 14 14 19 15
15 20 14 14 11 11 11 14 14 14 11 11 11 11 14 11 14 14 11 11 14 14 11 14 14 11 11 11 11 11 11 14 14 11 11 11 11 11 11 11 11 11 14 11 14 11 11 11 11 11 11 11 11 11 11 14 14 14 19 15
15 20 14 11 11 14 14 14 14 11 11 11 11 11 11 11 11 11 11 11 11 14 14 14 14 14 14 11 11 11 11 11 11 11 14 11 11 11 14 11 11 11 11 11 11 11 16 17 17 17 17 18 11 11 11 14 14 11 19 15
15 20 11 11 11 11 14 11 11 11 11 11 11 11 11 11 11 11 11 11 11 11 11 11 14 14 14 11 14 11 14 11 11 14 14 11 11 14 14 11 11 11 11 11 11 11 19 15 15 15 15 20 11 11 11 11 11 11 19 15
15 20 11 14 11 11 14 14 11 11 16 17 17 17 17 17 17 17 17 18 11 11 11 14 14 11 14 14 11 11 14 14 14 14 11 11 11 11 16 17 17 17 18 11 11 11 19 15 15 29 15 20 11 11 11 11 11 14 19 15
15 20 14 14 11 11 11 11 11 11 19 15 15 15 15 15 15 15 15 20 11 11 11 11 14 14 11 14 14 14 11 11 14 14 11 11 11 11 19 15 15 15 20 11 11 11 19 15 29 15 15 20 11 11 11 11 14 11 19 15
15 20 14 14 11 11 11 11 11 11 19 15 15 15 15 29 15 15 15 20 11 11 11 11 14 11 11 11 14 14 14 14 14 14 11 11 11 11 19 15 15 15 27 17 17 17 28 15 15 15 15 20 11 14 11 14 14 11 19 15
15 20 14 11 11 11 11 11 11 11 19 15 15 15 29 15 15 15 15 20 11 11 11 11 11 11 11 11 11 14 11 14 14 11 11 11 14 14 19 15 15 15 15 29 29 29 15 15 15 15 15 20 11 11 14 14 11 14 19 15
15 20 11 11 11 14 11 14 11 11 19 15 15 15 15 15 15 15 15 20 11 11 11 11 11 11 14 11 11 11 11 14 11 11 11 11 11 14 19 15 15 15 15 15 15 15 15 15 15 25 22 23 11 11 11 14 11 14 19 15
15 20 11 11 14 11 14 11 11 11 21 22 26 15 15 15 15 15 25 23 11 11 11 14 11 14 11 11 11 11 11 11 11 14 14 11 11 11 19 29 15 15 15 15 15 15 15 15 15 20 11 11 11 11 11 11 11 14 19 15
15 20 11 11 11 11 11 11 11 11 11 14 19 15 15 15 15 15 20 11 11 11 11 11 11 11 11 11 11 11 11 14 11 11 11 14 11 11 19 15 15 15 15 15 15 29 15 15 15 20 11 11 11 11 11 11 14 11 19 15
15 20 11 11 14 14 14 11 11 14 11 11 19 15 15 15 15 15 20 14 14 14 11 11 11 11 11 11 11 11 14 14 14 11 11 11 11 11 19 15 15 15 15 15 15 15 15 15 15 20 11 11 11 11 11 14 11 11 19 15
15 20 11 11 11 14 14 14 11 11 11 11 21 22 26 15 15 15 20 11 14 11 11 11 11 11 11 11 11 11 11 11 14 11 11 11 11 11 21 22 22 22 22 22 22 22 22 22 22 23 11 11 11 11 11 11 11 14 19 15
15 20 14 11 11 11 11 11 11 11 11 11 11 11 19 15 15 15 20 11 11 11 11 11 11 11 14 11 11 11 11 11 11 11 11 11 11 11 11 11 11 11 11 14 11 11 11 11 11 11 11 11 11 14 11 11 11 14 19 15
15 20 11 14 11 11 11 11 11 14 11 11 11 11 19 15 15 15 20 14 11 11 11 11 11 11 11 14 11 11 11 11 11 11 11 14 14 11 11 11 11 11 11 11 14 14 11 11 11 11 11 11 14 11 11 11 14 14 19 15
15 20 11 14 14 11 11 11 11 11 11 14 11 11 19 15 29 15 20 14 11 11 11 11 11 11 11 11 11 11 11 11 11 11 11 14 11 11 11 11 11 14 11 11 14 14 11 11 11 11 11 11 11 11 11 11 14 14 19 15
15 27 17 17 17 17 17 17 18 11 11 11 11 14 19 15 15 15 20 11 11 11 11 14 11 11 11 14 11 11 11 11 11 11 14 11 14 11 11 11 11 11 14 11 11 14 11 11 11 11 11 11 11 14 11 14 14 11 19 15
15 15 15 15 15 15 15 15 20 11 11 11 14 14 19 15 15 15 20 11 11 14 14 14 11 14 14 11 11 11 11 11 11 11 11 11 11 11 11 14 14 11 11 11 11 11 11 11 11 11 11 11 11 14 14 14 11 11 19 15
15 15 15 15 29 15 15 15 20 11 11 16 17 17 28 15 15 15 20 11 14 14 14 14 14 14 16 17 17 17 17 18 11 11 11 11 11 11 11 14 11 11 11 14 14 11 11 11 11 11 11 11 14 14 11 11 14 11 19 15
15 15 15 15 15 15 15 15 20 11 11 19 15 15 15 15 15 15 27 17 17 17 17 17 17 17 28 15 15 15 15 20 11 14 14 11 11 11 11 11 11 11 11 11 11 11 11 11 11 11 11 11 14 11 11 11 11 14 19 15
15 15 15 15 15 15 15 25 23 11 11 19 15 15 15 15 15 15 15 15 15 15 15 15 15 15 15 15 15 15 15 20 11 14 14 11 11 11 11 11 11 11 11 11 11 11 11 11 11 11 11 11 11 11 11 11 11 14 19 15
15 15 15 15 15 15 15 20 11 11 11 19 15 15 15 15 15 15 15 15 15 29 15 15 15 15 15 15 15 29 15 20 11 11 11 11 11 14 11 11 11 11 11 11 11 11 11 11 11 11 11 11 11 11 11 11 14 14 19 15
15 15 15 15 15 15 15 20 11 11 11 19 15 15 15 15 15 15 15 15 15 15 15 15 15 15 15 15 15 15 15 20 11 11 11 11 14 14 11 11 11 11 11 14 11 11 11 14 14 11 11 11 14 11 11 14 14 14 19 15
15 15 15 15 15 15 15 20 11 11 11 19 15 15 15 15 15 15 15 15 15 15 15 15 15 15 15 15 15 15 15 20 14 11 11 14 14 14 14 14 11 11 11 11 14 11 11 11 14 14 11 14 14 11 11 14 11 11 19 15
15 25 22 22 22 22 22 23 11 11 11 19 15 15 15 29 15 15 15 15 15 15 15 15 15 15 15 15 15 15 15 20 14 11 11 11 11 11 14 14 14 11 11 11 11 11 11 11 14 14 14 14 14 11 11 11 11 11 19 15
15 20 11 11 14 11 11 11 11 11 11 19 15 15 15 15 15 15 15 15 15 15 15 15 15 15 15 15 15 15 15 20 14 14 11 11 14 11 11 14 11 11 11 11 11 11 11 11 11 14 14 14 14 14 11 11 11 11 19 15
15 20 14 14 11 11 11 11 11 11 11 19 15 15 15 15 15 15 15 15 15 15 15 15 15 15 15 15 29 15 15 20 14 14 14 11 11 11 11 11 11 11 11 11 11 11 11 11 11 14 14 14 14 14 14 11 11 11 19 15
15 20 14 11 14 11 11 11 11 11 11 19 15 15 15 15 15 15 15 15 15 15 15 15 15 15 15 15 15 15 15 20 11 11 14 11 11 11 11 11 11 11 11 11 11 11 11 11 14 14 14 14 14 11 14 11 14 11 19 15
15 20 11 14 11 11 11 11 11 11 11 21 22 22 22 22 22 26 15 15 15 15 15 15 15 25 22 22 22 22 22 23 11 11 14 14 14 14 11 11 11 11 11 11 11 11 11 14 14 14 11 11 11 14 11 14 11 11 19 15
15 20 14 14 11 11 11 11 14 11 11 11 14 11 14 14 14 19 15 15 15 15 15 15 15 20 14 14 11 14 11 14 11 11 11 11 11 11 11 11 11 11 11 14 11 11 11 14 11 11 11 11 11 14 14 11 11 11 19 15
15 20 14 11 14 11 11 11 11 14 11 11 14 14 11 14 11 19 15 15 15 29 15 15 15 20 14 11 14 14 14 14 11 11 11 11 11 11 11 11 11 11 14 14 11 11 11 11 11 11 11 11 11 14 14 11 11 11 19 15
15 20 11 11 14 14 11 11 11 11 11 11 11 11 14 14 14 19 15 15 15 15 15 15 15 20 14 14 14 11 14 11 11 11 11 13 11 11 11 11 11 14 14 14 14 11 11 11 11 11 11 11 11 11 11 11 11 14 19 15
15 20 11 11 11 11 11 11 11 11 11 11 11 11 11 14 11 19 15 15 15 15 15 15 15 20 14 11 11 14 11 11 11 14 11 11 11 11 11 11 11 14 11 11 11 14 14 11 11 11 11 11 11 11 11 11 14 14 19 15
15 20 11 11 11 11 11 11 11 11 11 11 11 11 11 11 11 19 15 15 15 15 15 15 15 20 11 11 14 11 11 11 14 11 11 11 11 11 14 11 11 11 14 14 14 11 14 11 11 11 11 11 11 11 11 14 11 14 19 15
15 20 11 11 11 11 11 11 11 11 11 11 11 11 11 11 14 19 15 15 15 15 15 15 15 20 11 11 14 14 11 11 11 11 11 11 11 11 11 11 14 11 11 14 14 14 11 11 11 11 11 11 14 14 14 11 14 14 19 15
15 20 11 11 11 14 11 11 11 11 11 11 11 11 14 11 14 19 15 15 15 15 15 15 15 20 11 14 11 14 14 11 11 11 11 11 11 11 14 14 11 11 11 11 14 11 11 11 11 11 11 11 11 14 11 11 11 11 19 15
15 20 11 14 14 14 11 14 14 11 11 11 11 11 11 11 11 19 15 15 15 15 15 29 15 20 14 14 11 11 14 11 11 11 11 14 11 11 11 11 11 11 11 11 11 11 11 11 11 14 11 11 11 11 14 14 14 11 19 15
15 20 14 14 14 11 11 14 11 11 11 11 11 11 14 14 14 19 15 15 15 15 15 15 15 20 11 14 14 11 11 11 11 14 11 14 14 11 11 11 14 16 17 17 17 17 18 11 14 11 11 11 11 11 11 14 14 14 19 15
15 20 11 14 11 11 11 11 11 11 14 16 17 17 17 17 17 28 15 29 15 15 15 15 15 20 14 11 14 11 11 11 11 14 14 11 11 14 11 14 14 19 15 15 15 15 20 14 14 14 14 11 11 11 11 14 11 14 19 15
15 20 11 11 11 11 11 11 11 14 11 19 15 15 15 15 15 15 15 15 15 15 15 15 15 20 14 14 11 11 11 11 11 11 11 11 11 11 11 11 14 19 15 29 15 15 27 17 17 17 17 17 18 11 11 11 14 11 19 15
15 20 11 11 11 13 11 11 11 14 14 19 15 15 15 15 15 15 15 15 15 15 15 15 15 20 14 14 11 11 11 11 11 11 11 11 11 11 14 14 14 19 15 15 15 15 15 15 15 15 15 15 20 11 11 11 11 14 19 15
15 20 14 11 11 11 11 11 14 14 14 19 15 15 15 15 15 15 15 15 15 15 15 15 15 20 11 11 11 11 14 14 14 11 11 11 11 14 14 11 11 19 15 15 15 15 15 15 15 29 15 15 20 14 14 11 11 11 19 15
15 20 14 14 11 11 11 11 14 11 11 19 15 29 15 15 15 15 15 15 15 25 22 22 22 23 11 11 11 11 11 14 14 11 11 11 11 11 14 14 11 19 15 15 29 15 15 15 15 15 15 15 20 14 11 14 14 11 19 15
15 20 11 11 14 11 11 11 11 11 14 19 15 15 15 15 15 15 15 29 15 20 11 14 14 14 11 11 11 11 11 11 14 11 11 11 11 11 11 14 14 19 15 15 15 15 15 15 15 15 15 15 27 17 17 17 17 17 28 15
15 20 11 14 14 11 11 11 11 11 14 19 15 15 15 15 15 15 15 15 15 20 11 11 14 14 11 11 11 11 11 11 11 11 11 11 11 11 14 11 11 21 22 22 22 22 26 15 15 15 15 15 15 15 15 15 15 15 15 15
15 20 14 11 14 11 11 11 11 14 14 21 22 22 22 22 22 22 22 22 22 23 11 11 11 11 11 11 11 11 11 11 11 11 11 11 11 11 11 11 14 14 14 11 14 11 19 15 15 15 15 15 15 15 15 15 15 15 15 15
15 20 14 14 11 14 11 11 11 11 14 14 14 11 11 11 11 14 11 11 11 11 11 11 14 14 14 14 11 11 11 11 11 13 11 11 11 11 14 14 11 11 11 11 14 14 19 15 15 15 15 15 15 15 15 15 15 15 15 15
15 27 17 17 17 17 17 18 11 11 11 11 11 14 11 14 14 14 14 11 11 14 14 11 14 11 14 14 14 11 11 11 11 11 11 11 11 11 11 14 11 14 14 11 11 14 19 15 15 15 15 15 15 15 15 15 15 15 15 15
15 15 15 15 15 15 15 20 14 11 11 11 11 11 14 14 14 11 11 11 11 14 11 14 11 14 11 11 11 11 11 11 11 11 11 11 11 11 11 11 14 11 14 11 14 11 19 15 15 15 29 15 15 15 15 25 22 22 26 15
15 15 15 15 15 15 15 20 11 11 11 11 11 11 11 14 11 11 11 11 14 11 11 11 14 11 11 11 11 11 11 11 14 14 11 11 11 11 11 11 11 14 11 11 11 11 19 15 15 29 15 15 15 15 15 20 14 11 19 15
15 15 15 15 15 15 15 20 11 14 11 11 11 11 14 11 14 11 11 11 14 11 14 11 14 11 11 11 11 11 11 14 14 11 14 11 11 11 11 11 11 11 11 11 11 11 19 15 15 15 15 15 15 15 15 20 11 11 19 15
15 15 15 15 15 15 15 20 14 14 14 11 11 11 11 11 11 11 11 14 11 11 11 14 14 11 11 11 11 11 14 14 11 11 14 14 11 11 11 14 11 11 11 11 11 11 21 22 22 22 22 22 22 22 22 23 11 11 19 15
15 15 15 15 29 15 15 20 14 14 14 11 11 14 11 11 11 11 11 11 11 11 11 11 11 11 11 11 14 11 14 14 11 14 11 14 14 11 14 14 11 11 11 11 11 11 11 11 11 11 11 11 11 11 11 11 11 11 19 15
15 15 15 15 15 15 15 20 11 11 11 14 14 11 11 11 11 11 11 11 11 11 11 11 11 11 11 14 14 14 14 11 14 14 14 14 14 14 14 14 14 11 11 11 11 11 11 11 11 11 11 11 11 11 11 11 11 14 19 15
15 15 15 15 15 15 15 27 17 17 17 17 17 17 17 17 17 17 17 17 17 17 17 17 17 17 17 17 17 17 17 17 17 17 17 17 17 17 17 17 17 17 17 17 17 17 17 17 17 17 17 17 17 17 17 17 17 17 28 15
15 15 15 15 15 15 15 15 15 15 15 15 15 15 15 15 15 15 15 15 15 15 15 15 15 15 15 15 15 15 15 15 15 15 15 15 15 15 15 15 15 15 15 15 15 15 15 15 15 15 15 15 15 15 15 15 15 15 15 15