14 14 14 14 14 14 14 14 14 14 14 14 14 14 14 14 14 14 21 22 22 22 22 22 22 22 22 23 14 14 14 14 14 14 14 14 14 14 14 14 14 14 14 14 14 14 14 14 14 14 
14 14 14 14 14 14 14 14 14 14 14 14 14 14 14 14 14 14 14 11 11 11 11 11 11 11 11 14 14 14 14 14 14 14 14 14 14 14 14 14 14 14 14 14 14 14 14 14 14 14 
14 14 14 14 14 14 14 14 14 14 14 14 14 14 14 14 14 14 11 11 11 11 11 11 11 14 11 11 14 14 14 14 14 14 14 14 14 14 14 14 14 14 14 14 14 14 14 14 14 14 
17 17 18 14 14 14 14 14 14 14 14 14 14 14 14 14 14 11 11 11 14 11 11 11 11 11 11 11 11 11 11 11 11 11 11 11 11 11 11 14 14 14 14 14 14 14 14 14 14 14 
15 15 20 14 14 14 14 14 14 14 14 14 14 14 14 14 14 11 11 11 11 11 11 11 11 11 11 11 11 11 11 11 11 11 11 11 11 11 11 14 14 14 14 14 14 14 14 14 14 14 
15 15 20 14 14 14 14 14 14 14 14 14 14 14 14 14 14 11 11 11 11 11 14 11 11 11 11 11 11 14 14 14 14 14 14 14 14 11 11 14 14 14 14 14 14 14 14 14 14 14 
15 15 20 11 14 14 14 14 24 24 24 24 24 14 14 14 14 14 11 11 11 11 11 11 11 11 11 11 14 14 14 14 14 14 14 14 14 11 11 14 14 14 14 14 14 14 14 14 14 14 
15 15 20 11 11 11 11 11 24 13 13 13 24 14 14 14 14 14 14 11 11 11 11 11 11 11 11 14 14 14 14 14 14 11 11 11 11 11 11 11 11 14 14 14 14 14 14 14 14 14 
15 15 20 11 11 11 11 11 11 13 13 13 24 14 14 14 14 14 14 14 11 11 11 11 11 14 14 14 14 14 14 14 14 14 11 11 11 11 11 11 11 11 14 14 14 14 14 14 14 14 
15 15 20 11 11 11 11 11 24 13 13 13 24 14 14 14 14 14 14 14 14 11 11 11 11 14 14 14 14 14 14 14 14 14 11 11 11 11 11 11 11 11 14 14 14 14 14 14 14 14 
15 15 20 11 14 14 14 14 24 13 13 13 24 14 14 14 14 14 14 14 14 14 11 11 14 14 14 14 14 14 14 14 14 14 11 11 11 11 11 11 11 11 14 14 14 14 14 14 14 14 
15 15 20 11 14 14 14 14 24 24 24 24 24 14 14 14 14 14 14 14 14 14 11 11 14 14 14 14 14 14 14 14 14 14 11 11 11 11 11 11 11 11 14 14 14 14 14 14 14 14 
15 15 20 11 14 14 14 14 14 14 11 14 14 14 14 14 14 14 14 14 14 14 11 11 14 14 14 14 14 14 14 14 14 14 14 11 11 11 11 11 11 14 14 14 14 14 14 14 14 14 
15 15 20 11 14 14 14 14 14 14 11 14 14 14 14 14 14 14 14 14 14 14 11 11 14 14 14 14 14 14 14 14 14 14 14 14 14 11 11 14 14 14 14 14 14 14 14 14 14 14 
15 15 20 11 14 14 14 14 14 14 11 14 14 14 14 11 11 11 11 11 11 11 11 11 14 14 14 14 14 14 14 14 14 14 14 14 14 11 11 14 14 14 14 14 14 14 14 14 14 14 
15 15 20 11 11 11 11 11 11 14 11 14 14 14 14 11 11 14 14 14 14 14 11 11 14 14 14 14 14 14 14 14 14 14 14 14 14 11 11 14 14 14 14 14 14 14 14 14 14 14 
22 22 23 11 11 11 11 11 11 14 11 14 14 14 14 11 11 14 14 14 14 14 11 11 14 14 14 14 14 14 14 14 14 14 14 14 14 11 11 14 14 14 14 14 14 14 14 14 14 14 
14 14 14 14 14 14 14 11 11 14 11 14 14 14 14 11 11 14 14 14 14 14 11 11 14 14 14 14 14 14 14 14 14 14 14 14 11 11 11 14 14 14 14 14 14 14 14 14 14 14 
14 14 14 14 14 14 14 11 11 14 11 14 14 14 14 11 11 14 14 14 14 11 11 11 11 14 14 14 14 14 14 14 14 14 14 11 11 11 11 14 14 14 14 14 14 16 17 17 17 18 
14 14 14 14 14 14 14 11 11 14 11 14 14 14 14 11 11 14 14 14 11 11 11 11 11 11 14 14 14 14 14 14 14 14 14 11 11 14 14 14 14 14 14 14 14 19 15 15 15 20 
14 14 14 14 14 14 14 11 11 14 11 11 11 11 11 11 11 11 11 11 11 11 11 11 11 11 11 11 11 11 11 11 11 11 11 11 11 11 11 11 11 11 11 11 11 19 15 15 15 20 
14 14 14 14 14 14 14 11 11 14 14 14 14 14 14 11 11 11 11 11 11 11 11 11 11 11 11 11 11 11 11 11 11 11 11 11 11 14 14 14 14 14 14 14 11 19 15 15 15 20 
14 14 14 14 14 14 14 11 11 14 14 14 14 14 14 11 11 14 14 11 11 11 11 11 11 11 11 14 14 14 14 14 14 14 14 11 11 14 14 14 14 14 14 14 11 21 22 22 22 23 
14 14 14 14 14 14 14 11 11 14 14 14 14 14 14 11 11 14 14 14 11 11 11 11 11 11 14 14 14 14 14 14 14 14 14 11 11 14 14 14 14 14 14 14 11 11 11 11 11 14 
14 14 14 14 14 14 14 11 11 14 14 14 14 14 14 11 11 14 14 14 14 11 11 11 11 14 14 14 14 14 14 14 14 14 14 11 11 14 14 14 14 14 14 14 14 14 14 11 11 14 
14 14 14 14 14 14 14 11 11 14 14 14 14 14 14 14 14 14 14 14 14 14 11 11 14 14 14 14 14 14 14 14 14 14 14 11 11 14 14 14 14 14 14 14 14 14 14 11 11 14 
14 14 14 14 14 14 14 11 11 14 14 14 14 14 14 14 14 14 14 14 14 14 11 11 14 14 14 14 14 14 14 14 14 14 14 11 11 14 14 14 14 14 14 14 14 14 14 11 11 14 
14 14 14 14 14 14 14 11 11 14 14 14 14 14 14 14 14 14 14 14 14 14 11 11 14 14 14 11 14 14 14 14 14 14 16 17 17 18 14 14 14 14 14 14 14 14 14 11 11 14 
14 14 14 14 14 14 14 14 11 14 14 14 14 14 14 14 14 14 14 14 14 14 11 11 14 14 14 14 14 14 11 14 14 14 19 15 15 20 14 14 14 14 14 14 14 14 14 11 11 14
14 14 14 14 14 14 14 11 11 11 11 11 11 11 14 14 14 14 14 14 14 14 11 11 14 14 14 14 14 14 11 14 14 14 21 22 22 23 14 14 14 14 14 14 14 14 14 11 11 14 
14 14 14 14 14 14 14 11 11 11 11 11 11 11 14 14 14 14 14 14 14 14 11 11 14 14 14 14 14 14 14 14 14 14 14 14 14 14 14 14 14 14 14 14 14 14 14 11 11 14 
14 14 14 14 14 14 14 14 11 11 11 11 11 11 11 14 14 14 14 14 14 14 11 11 14 14 14 14 14 14 14 14 14 14 14 14 14 14 14 14 14 14 14 14 14 14 14 11 11 14 
14 14 14 14 14 14 14 14 11 11 11 11 11 11 11 14 14 14 14 14 14 14 11 11 14 14 14 14 14 14 14 14 14 14 14 11 11 11 14 11 11 11 11 11 11 11 11 11 11 14 
14 14 14 14 14 14 14 14 11 11 11 11 11 11 11 14 14 14 14 14 14 14 11 11 14 14 14 14 14 14 14 14 14 14 14 11 11 11 11 11 11 11 11 11 11 11 11 11 11 14 
14 14 14 14 14 14 14 14 11 11 11 11 11 11 11 14 14 14 14 14 14 14 11 11 14 14 14 14 14 14 14 14 14 14 14 11 11 11 14 14 14 14 14 14 14 14 14 14 14 14 
14 14 14 14 14 14 14 14 14 14 11 14 14 14 14 14 14 14 14 14 14 14 11 11 14 14 14 14 14 14 14 14 14 14 14 11 11 11 14 14 14 14 14 14 14 14 14 14 14 14 
14 14 14 14 14 14 14 14 14 14 11 14 14 14 14 14 14 14 14 11 11 11 11 11 11 11 11 14 14 14 14 14 14 14 11 11 11 11 11 14 14 14 14 14 14 14 14 14 14 14 
14 14 14 14 14 14 14 14 14 14 11 14 14 14 14 14 14 14 11 11 11 11 11 11 11 11 11 11 14 14 11 14 14 11 11 11 11 11 11 14 14 14 14 14 14 14 14 14 14 14 
14 14 14 14 14 14 14 14 14 14 11 11 11 11 14 14 14 14 11 11 11 11 14 11 11 11 11 11 14 14 14 14 11 11 11 11 11 11 11 14 14 14 14 14 14 14 14 14 14 14 
14 14 14 14 14 14 14 14 14 14 11 11 11 11 14 14 14 14 11 11 11 11 11 11 11 11 11 11 14 14 14 11 11 11 11 11 11 14 11 14 14 14 14 14 14 14 14 14 14 14 
14 14 14 14 14 14 14 14 14 14 14 14 11 11 14 14 14 14 11 11 11 14 11 11 11 11 11 11 11 11 11 11 11 11 14 11 11 11 11 14 14 14 14 14 14 14 14 14 14 14 
14 14 14 14 14 14 14 14 14 14 14 14 11 11 14 14 14 14 14 11 11 11 11 11 14 11 11 14 14 14 14 11 11 11 11 11 11 11 11 14 14 14 14 14 14 14 14 14 14 14 
14 14 14 14 14 14 14 14 14 14 14 14 11 11 14 14 14 14 14 14 14 14 14 11 11 11 14 14 14 14 14 11 11 14 11 11 14 11 11 14 14 14 14 14 14 14 14 14 14 14 
14 14 14 14 14 14 14 14 14 14 14 14 11 11 14 14 16 17 17 17 17 18 14 11 11 11 14 14 14 14 14 14 11 11 11 11 11 11 14 14 14 14 14 14 14 14 14 14 14 14 
14 14 14 14 14 14 14 14 14 14 14 14 11 11 14 14 19 15 15 15 15 20 14 11 11 11 14 14 14 14 14 14 14 14 14 14 14 14 14 14 14 14 14 14 14 14 14 14 14 14 
14 14 14 14 14 14 14 14 14 14 14 14 11 11 14 14 19 15 15 15 15 20 14 11 11 11 14 14 14 14 14 14 14 14 14 14 14 14 14 14 14 14 14 14 14 14 14 14 14 14 
14 14 14 14 14 14 14 14 14 14 14 14 11 11 14 14 19 15 15 15 15 20 14 11 11 11 14 14 14 14 14 14 14 14 14 14 14 14 14 14 14 14 14 14 14 14 14 14 14 14 
14 14 14 14 14 14 14 14 14 14 14 14 11 11 14 14 21 22 22 22 22 23 14 11 11 11 11 11 11 11 11 14 14 14 14 14 14 14 14 14 14 14 14 14 14 14 14 14 14 14 
14 14 14 14 14 14 14 14 14 14 14 14 11 11 11 11 11 11 11 11 11 11 11 11 11 11 11 11 11 11 11 14 14 14 14 14 14 14 14 14 14 14 14 14 14 14 14 14 14 14 
14 14 14 14 14 14 14 14 14 14 14 14 14 14 14 14 14 14 14 14 14 14 14 14 14 14 14 14 14 14 14 14 14 14 14 14 14 14 14 14 14 14 14 14 14 14 14 14 14 14 